##################################################
#                                               #
#                                               #
#                                               #
#  $                                            #
#                                               #
#                                               #
#                                $              #
#                                               #
#                                              >#
##################################################