##################################################
#<@                                             #
#                                               #
#                                               #
#  $               ###                          #
#                  # #                          #
#                  ###                          #
#                                               #
#                                               #
#                                               #
#                                              >#
##################################################