##################################################
#<                                              #
#                                               #
#                                               #
#  $               ###                          #
#                                               #
#                                               #
#                                $              #
#                                               #
#                                               #
#                                              >#
##################################################