#######
#@    #
#     #
#     #
#  $ >#
#######