#################################################
#<                                              #
#                                               #
#                                               #
#  $               ###                          #
#                  # #                          #
#                  ###                          #
#                                               #
#                                               #
#                                               #
#                                              >#
#################################################